$090,$00,$090,$00,$090,$00,$090,$00,$08C,$00,$090,$00,$08D,$00,$08E,$00,$090,$00,$090,$00,$090,$00,$090,$00,$090,$00,$08F,$00,$090,$00,$090,$00,$090,$00,$090,$00,$090,$00,$090,$00
$090,$00,$090,$00,$090,$00,$090,$00,$080,$00,$081,$00,$082,$00,$083,$00,$084,$00,$085,$00,$086,$00,$087,$00,$088,$00,$089,$00,$08A,$00,$08B,$00,$090,$00,$090,$00,$090,$00,$090,$00
$090,$00,$090,$00,$090,$00,$090,$00,$090,$00,$090,$00,$090,$00,$090,$00,$090,$00,$090,$00,$090,$00,$090,$00,$090,$00,$090,$00,$090,$00,$090,$00,$090,$00,$090,$00,$090,$00,$090,$00
$091,$00,$091,$00,$091,$00,$091,$00,$091,$00,$091,$00,$091,$00,$091,$00,$091,$00,$091,$00,$091,$00,$091,$00,$091,$00,$091,$00,$091,$00,$091,$00,$091,$00,$091,$00,$091,$00,$091,$00
$091,$00,$091,$00,$091,$00,$091,$00,$091,$00,$091,$00,$091,$00,$091,$00,$091,$00,$091,$00,$091,$00,$091,$00,$091,$00,$091,$00,$091,$00,$091,$00,$091,$00,$091,$00,$091,$00,$091,$00
$091,$00,$091,$00,$091,$00,$091,$00,$091,$00,$091,$00,$091,$00,$091,$00,$091,$00,$091,$00,$091,$00,$091,$00,$091,$00,$091,$00,$091,$00,$091,$00,$091,$00,$091,$00,$091,$00,$091,$00
$091,$00,$091,$00,$091,$00,$091,$00,$091,$00,$091,$00,$091,$00,$0A0,$01,$0A1,$01,$0A2,$01,$0A3,$01,$0A4,$01,$0A5,$01,$091,$00,$091,$00,$091,$00,$091,$00,$091,$00,$091,$00,$091,$00
$091,$00,$091,$00,$091,$00,$091,$00,$091,$00,$091,$00,$091,$00,$0B0,$01,$0B1,$01,$0B2,$01,$0B3,$01,$0B4,$01,$0B5,$01,$091,$00,$091,$00,$091,$00,$091,$00,$091,$00,$091,$00,$091,$00
$091,$00,$091,$00,$091,$00,$091,$00,$091,$00,$091,$00,$091,$00,$0C0,$01,$0C1,$01,$0C2,$01,$0C3,$02,$0C4,$02,$0C5,$02,$091,$00,$091,$00,$091,$00,$091,$00,$091,$00,$091,$00,$091,$00
$091,$00,$091,$00,$091,$00,$091,$00,$091,$00,$091,$00,$091,$00,$0D0,$01,$0D1,$01,$0D2,$01,$0D3,$02,$0D4,$02,$0D5,$02,$091,$00,$091,$00,$091,$00,$091,$00,$091,$00,$091,$00,$091,$00
$091,$00,$091,$00,$091,$00,$091,$00,$091,$00,$091,$00,$091,$00,$0E0,$01,$0E1,$01,$0E2,$01,$0E3,$02,$0E4,$02,$0E5,$02,$091,$00,$091,$00,$091,$00,$091,$00,$091,$00,$091,$00,$091,$00
$091,$00,$091,$00,$091,$00,$091,$00,$091,$00,$091,$00,$091,$00,$0F0,$01,$0F1,$01,$0F2,$01,$0F3,$01,$0F4,$01,$0F5,$01,$091,$00,$091,$00,$091,$00,$091,$00,$091,$00,$091,$00,$091,$00
$091,$00,$091,$00,$091,$00,$091,$00,$091,$00,$091,$00,$091,$00,$091,$00,$091,$00,$091,$00,$091,$00,$091,$00,$091,$00,$091,$00,$091,$00,$091,$00,$091,$00,$091,$00,$091,$00,$091,$00
$091,$00,$091,$00,$091,$00,$091,$00,$091,$00,$091,$00,$091,$00,$091,$00,$091,$00,$091,$00,$091,$00,$091,$00,$091,$00,$091,$00,$091,$00,$091,$00,$091,$00,$091,$00,$091,$00,$091,$00
$091,$00,$091,$00,$091,$00,$091,$00,$091,$00,$091,$00,$091,$00,$091,$00,$091,$00,$091,$00,$091,$00,$091,$00,$091,$00,$091,$00,$091,$00,$091,$00,$091,$00,$091,$00,$091,$00,$091,$00
$090,$00,$090,$00,$090,$00,$090,$00,$090,$00,$090,$00,$090,$00,$090,$00,$090,$00,$090,$00,$090,$00,$090,$00,$090,$00,$090,$00,$090,$00,$090,$00,$090,$00,$090,$00,$090,$00,$090,$00
$090,$00,$090,$00,$090,$00,$090,$00,$097,$00,$098,$00,$099,$00,$09A,$00,$09B,$00,$09C,$00,$09D,$00,$09E,$00,$09F,$00,$0A7,$00,$0A8,$00,$0A9,$00,$090,$00,$090,$00,$090,$00,$090,$00
$090,$00,$090,$00,$090,$00,$090,$00,$090,$00,$090,$00,$090,$00,$090,$00,$090,$00,$090,$00,$090,$00,$090,$00,$090,$00,$090,$00,$090,$00,$090,$00,$090,$00,$090,$00,$090,$00,$090,$00
