$090,$00,$090,$00,$090,$00,$090,$00,$090,$00,$090,$00,$090,$00,$090,$00,$090,$00,$090,$00,$090,$00,$090,$00,$090,$00,$090,$00,$090,$00,$090,$00,$090,$00,$090,$00,$090,$00,$090,$00
$090,$00,$090,$00,$080,$00,$081,$00,$082,$00,$083,$00,$084,$00,$085,$00,$086,$00,$087,$00,$088,$00,$089,$00,$08A,$00,$08B,$00,$08C,$00,$08D,$00,$08E,$00,$08F,$00,$090,$00,$090,$00
$090,$00,$090,$00,$090,$00,$090,$00,$090,$00,$090,$00,$090,$00,$090,$00,$090,$00,$090,$00,$090,$00,$090,$00,$090,$00,$090,$00,$090,$00,$090,$00,$090,$00,$090,$00,$090,$00,$090,$00
$091,$00,$091,$00,$091,$00,$091,$00,$091,$00,$091,$00,$091,$00,$091,$00,$091,$00,$091,$00,$091,$00,$091,$00,$091,$00,$091,$00,$091,$00,$091,$00,$091,$00,$091,$00,$091,$00,$091,$00
$091,$00,$091,$00,$091,$00,$091,$00,$091,$00,$091,$00,$091,$00,$091,$00,$091,$00,$091,$00,$091,$00,$091,$00,$091,$00,$091,$00,$091,$00,$091,$00,$091,$00,$091,$00,$091,$00,$091,$00
$091,$00,$091,$00,$091,$00,$091,$00,$091,$00,$091,$00,$091,$00,$0A0,$01,$0A1,$01,$0A2,$01,$0A2,$21,$0A1,$21,$0A0,$21,$091,$00,$091,$00,$091,$00,$091,$00,$091,$00,$091,$00,$091,$00
$091,$00,$091,$00,$091,$00,$091,$00,$091,$00,$091,$00,$091,$00,$0B0,$01,$0B1,$01,$0B2,$01,$0B2,$21,$0B1,$21,$0B0,$21,$091,$00,$091,$00,$091,$00,$091,$00,$091,$00,$091,$00,$091,$00
$091,$00,$091,$00,$091,$00,$091,$00,$091,$00,$091,$00,$091,$00,$0C0,$01,$0C1,$01,$0C2,$01,$0C2,$21,$0C1,$21,$0C0,$21,$091,$00,$091,$00,$091,$00,$091,$00,$091,$00,$091,$00,$091,$00
$091,$00,$091,$00,$091,$00,$091,$00,$091,$00,$091,$00,$091,$00,$0C0,$41,$0C1,$41,$0C2,$41,$0C2,$61,$0C1,$61,$0C0,$61,$091,$00,$091,$00,$091,$00,$091,$00,$091,$00,$091,$00,$091,$00
$091,$00,$091,$00,$091,$00,$091,$00,$091,$00,$091,$00,$091,$00,$0B0,$41,$0B1,$41,$0B2,$41,$0B2,$61,$0B1,$61,$0B0,$61,$091,$00,$091,$00,$091,$00,$091,$00,$091,$00,$091,$00,$091,$00
$091,$00,$091,$00,$091,$00,$091,$00,$091,$00,$091,$00,$091,$00,$0A0,$41,$0A1,$41,$0A2,$41,$0A2,$61,$0A1,$61,$0A0,$61,$091,$00,$091,$00,$091,$00,$091,$00,$091,$00,$091,$00,$091,$00
$091,$00,$091,$00,$091,$00,$091,$00,$091,$00,$091,$00,$091,$00,$091,$00,$093,$01,$094,$01,$095,$01,$096,$01,$091,$00,$091,$00,$091,$00,$091,$00,$091,$00,$091,$00,$091,$00,$091,$00
$091,$00,$091,$00,$091,$00,$091,$00,$091,$00,$091,$00,$091,$00,$091,$00,$0A3,$01,$0A4,$01,$0A5,$01,$0A6,$01,$091,$00,$091,$00,$091,$00,$091,$00,$091,$00,$091,$00,$091,$00,$091,$00
$091,$00,$091,$00,$091,$00,$091,$00,$091,$00,$091,$00,$091,$00,$091,$00,$0B3,$01,$0B4,$01,$0B5,$01,$0B6,$01,$091,$00,$091,$00,$091,$00,$091,$00,$091,$00,$091,$00,$091,$00,$091,$00
$091,$00,$091,$00,$091,$00,$091,$00,$091,$00,$091,$00,$091,$00,$091,$00,$091,$00,$091,$00,$091,$00,$091,$00,$091,$00,$091,$00,$091,$00,$091,$00,$091,$00,$091,$00,$091,$00,$091,$00
$090,$00,$090,$00,$090,$00,$090,$00,$090,$00,$090,$00,$090,$00,$090,$00,$090,$00,$090,$00,$090,$00,$090,$00,$090,$00,$090,$00,$090,$00,$090,$00,$090,$00,$090,$00,$090,$00,$090,$00
$090,$00,$090,$00,$090,$00,$090,$00,$097,$02,$098,$02,$099,$02,$09A,$02,$09B,$02,$09C,$02,$09D,$02,$09E,$02,$09F,$02,$0A7,$02,$0A8,$02,$0A9,$02,$090,$00,$090,$00,$090,$00,$090,$00
$090,$00,$090,$00,$090,$00,$090,$00,$090,$00,$090,$00,$090,$00,$090,$00,$090,$00,$090,$00,$090,$00,$090,$00,$090,$00,$090,$00,$090,$00,$090,$00,$090,$00,$090,$00,$090,$00,$090,$00
